R 1080 720
NO ./textures/wall.xpm
SO ./textures/denisbis.xpm
WE ./textures/wood.xpm
EA ./textures/stone.xpm
S ./textures/sprite.xpm
F 150,0,0


C 0,250,250
1 1 1 1 1 1 1 1
1 0 0 0 0 0 0 1
1 0 0 0 0 0 0 1
1 0 0 0 0 0 0 1
1 0 0 0 0 0 0 1
1 0 1 0 1 0 0 1
1 1 1 3 1 1 1 1
1 0 1 0 1 0 0 1
1 0 0 0 0 0 0 1
1 0 0 2 0 0 0 1
1 0 0 N 0 0 0 1
1 0 0 0 0 0 0 1
1 0 2 0 0 0 0 1
1 0 0 0 0 2 0 1
1 0 0 0 0 0 0 1
1 1 1 1 1 1 1 1
